NO ./textures/redbrick.xpm
SO ./textures/bluestone.xpm
WE ./textures/colorstone.xpm
EA ./textures/mossy.xpm
F 30,225,0
C 0,0,220

        1111111111111111111111111
        1000000000110000000000001
        1011000001110000001000001
        10000S0000000000000100001
111111111011000001110000001000001
100000000011000001110111111111111
11110111111111011100000010001
11110111111111011101010010001
11100010110101011100000010001
10001000100000001100000010001
10000100010001001101010010001
1100000111010101111101111010111
11110111 1110101 101111010001
11111111 1111111 111111111111
